________________________________ Episode 1 part 1 ________________________________ 
gotta = مجبور بودن
hump = قوز کردن
hair piece = کلاه گیس 
chalk = گچ (چاک)
through = از میان (ثَُرو)
sound = صوت | به نظر رسیدن
middle = وسط، متوسط
realize = فهمیدن
totally = کاملا
naked = لخت
dream = رویا دیدن | خواب دیدن
instead = در عوض
sudden = ناگهان (سان)
weird = عجیب (ویِرد)
myself = خودم
sweetie = عزیزم
grabbed = چنگ انداختن | قاپیدن
intestine = روده (اینتِستین)
pulled = شکسته شده
mouth = دهان 
tied = گره خورده است
cookie = بسکویت، کلوچه، شیرینی خشک
aura = هاله
alone = تنها
hell = جهنم | تجربه تلخ 
loud = بلند، پر سر و صدا
hurting |‌ hurt = صدمه دیدن، احساس درد داشتن
strip joints = کاباره | کلوپ رقص بدون لباس
hammer = چکش
might = ممکن
decaf = بدون کافئین
survivor = بازمانده (سو وایوِر)
tell us = به ما بگو
wet = مرطوب
bridesmaids = ساقدوش ها (بِرایدز مِید)
half-hour = نیم ساعت
gravy = سس گریوی (نوعی سس برای مزه دار کردن گوشت که معمولا در ظرف های قایقی شکل قرار میگیرد)
gorgeous = زیبا | شکیل (گارجِس )
freaked = ترسیده
hit = ضربه
familiar = آشنا
anyway = به هر حال
wondering = تعجب
drifted apart = از هم جدا شد
issue = مسئله (ایشیو)
pipe = لوله
organ = اندام
guess = حدس
bought = خرید
matters = مسائل
should = باید
purse = کیف پول
metaphor = استعاره
trouble = مشکل (تِرابل)
breathe = نفس کشیدن
calm = آرام
whiskers = سبیل
probably = احتمالا
independence = استقلال
across = در عرض
hall = سالن
rule = قانون
horrible = وحشتناک
buzz = به صدا در آمدن | وزوز کردن
catch = گرفتن
pulled = تحلیل رفته | شکسته شده 
eyelash = مژه (آیلَش)
supposed = فرضی
honeymoon = ماه عسل
though = هر چند
lizards = مارمولک
hang = آویزان
been = بوده
could = توانستن، ممکن بودن
attach = وصل کردن
bunch = دسته
worm = کرم
whatsoever = به هیچ وجه | ابدا
established = ایجاد
decision = تصمیم گیری (دِسیشِن)
moved = نقل مکان کردن
guy = مرد
push = حل دادن 



hitting on = مخ زدن
come on = بیخیال 
go on = ادامه بده
wate a minute = یک دقیقه صبر کن
I wanna kill myself = من میخوام خودمو بکشم
Are you okay sweetie = اوکیی عزیزم ؟
I feel = من حس میکنم
To hell weth her = منو برد به جهنم خودش
lesten to me = به من گوش کن
who's Ali = علی کیه ؟
I have no idea = من ایده ای ندارم
that's right = درسته 
come in = بیا تو



I've = I have
we've = we have
I'll = I will
wanna = want to


grammer note : 
if "the" was before word with (a, e, o, i, u) we don't say "the", we say "thi"
for example : what the awnser is  = وات دی انسر ایس ؟ 



________________________________ Episode 1 part 2 ________________________________ 
let = اجازه
screwed = پیچ شده
such = چنین
idiot = احمق
caught = گرفتار
dentist = دندان پزشک
mess = آشفتگی
accidentally = تصادفی
valuable = ارزشمند
broke = شکست
socks = جوراب
scary = ترسناک
case = مورد
flavor = طعم
rocky = سنگی
dough = خمیر
cherry = گیلاس
vanilla = وانیل
nuts = آجیل
whipped cream = خامه فرم گرفته
happened = اتفاق افتاد
grab = چنگ زدن
honestly = صادقانه
horny = شاخدار
ever since = از آن زمان
noodles = رشته فرنگی
revelation = افشاگری
able = قادر
preform = قبلا تشکیل دادن، 
sexually = (سِکشولی) جنسی  
being = بودن (در حال انجام دادن درهمین الان)
spit = تف
glad = خوشحالم
smashed = شکست
lawful = قانونی
difference = تفاوت
hero = قهرمان
enough = کافی
while = در صورتی که | هنگامی که
Alwhough = هر چند
doubt = شک
mostly = بیشتر
regional = منطقه ای
unless = مگر اینکه
production = تولید
abuse = سوء استفاده
once = یکبار
wooden = چوبی
smiling = خندان
slept = خوابیده (simple past)
hanger = چوب لباسی
luck = شانس
credit = اعتبار 
snap = ضربه محکم و ناگهانی | بشکن زدن
turtle = لاک پشت
sophisticated = پیچیده
into = به
sort = مرتب کردن
beacon = فانوس دریایی
severe = شدید
emotional = احساسی
feet = کف پا
trained = آموزش دیده
laughed = خندید (simple past)
surprisingly = به طرز شگفت انگیزی
upbeat = خوشبین
sale = فروش
pay = پرداخت
credit card = کارت اعتباری
whole = کل
own = خود
prison = زندان
anybody = هر کسی
windshields =  شیشه جلو
aromatherapy = رایحه درمانی
suck = مکیدن | ساک زدن
crash = تصادف
couch = نیمکت
put = قرار دادن
split = تقسیم
major = رشته
figured = رقم زده
older = بزرگتر
vulnerability = آسیب پذیری
become = تبدیل شدن
factor = فاکتور
hear = بشنو


I did = انجام دادم
I don't think so = من اینطور فکر نمی کنم
it's okay = اوکیه 
All finished = همه چی تموم شد
what for = برای چی ؟
geek = گیک (به انگلیسی: Geek ) یک اصطلاح عامیانه است و به کسی با رفتارهای عجیب و غیر متعارف گفته می‌شود؛ ولی معانی دیگری مانند، «متخصص یا علاقه‌مند رایانه» نیز دارد که بدان رایانه‌باز نیز می‌گویند. گیک در گذشته نوعی توهین محسوب می‌شد و به معنی دیوانه یا احمق بود، اما به مرور زمان و بعد از انقلاب دیجیتال، تغییر معنا داد.



________________________________ Episode 2 part 1 ________________________________ 